6 6 6 6 6 6 6 6 6 6 6 6 6 6 6 6 6 6 6 6 6 6 6 6 6 6 6 6 6 6 6 6 6 6 6 6 6 6 6 6 6 6 6 6 6 6 6 6 6 6 
6 6 6 6 6 6 6 6 6 6 6 6 6 6 6 6 6 6 6 6 6 6 6 6 6 6 6 6 6 6 6 6 6 6 6 6 6 6 6 6 6 6 6 6 6 6 6 6 6 6 
6 6 6 6 6 6 6 6 6 6 6 6 6 6 6 6 6 6 6 6 6 6 6 6 6 6 6 6 6 6 6 6 6 6 6 6 6 6 6 6 6 6 6 6 6 6 6 6 6 6 
6 6 6 6 7 7 7 7 7 7 7 7 7 7 7 6 7 7 7 7 7 7 6 6 6 7 7 7 7 7 7 7 7 7 7 7 7 7 7 7 6 7 7 7 7 7 7 6 6 6 
6 6 6 9 12 12 12 12 12 12 12 12 12 12 12 6 20 19 20 19 20 12 6 6 6 12 12 12 12 12 12 12 12 12 12 12 12 12 12 12 6 12 12 12 12 12 12 8 6 6 
6 6 6 9 12 3 12 12 12 12 12 12 12 12 12 6 20 19 20 20 19 12 6 6 6 12 12 12 12 12 12 12 12 12 12 12 12 12 12 12 6 12 12 12 12 12 12 8 6 6 
6 6 6 9 12 12 12 12 12 12 12 12 12 12 12 6 20 20 19 20 20 12 6 6 6 12 12 12 12 12 12 12 12 12 12 12 12 12 12 12 6 12 12 12 12 12 12 8 6 6 
6 6 6 9 12 12 12 12 12 12 12 12 12 12 12 6 12 12 12 12 12 12 6 6 6 12 12 12 12 12 12 12 12 12 12 12 12 12 12 12 6 12 12 12 12 12 12 8 6 6 
6 6 6 9 12 12 12 12 12 12 12 12 12 12 12 6 12 12 12 12 12 12 6 6 6 7 7 7 7 7 7 7 7 7 12 12 12 12 12 12 6 12 12 12 12 12 12 8 6 6 
6 6 6 9 12 12 12 12 12 12 12 12 12 12 12 12 12 12 12 12 12 12 6 6 6 12 12 12 12 12 12 12 12 12 12 12 12 12 12 12 6 12 12 12 12 12 12 8 6 6 
6 6 6 9 6 6 6 6 6 6 6 6 6 12 12 12 12 12 12 12 12 12 6 6 6 12 12 12 12 12 12 12 12 12 12 12 12 12 12 12 6 12 12 12 12 12 12 8 6 6 
6 6 6 9 12 12 12 12 12 12 12 12 12 12 12 12 12 12 12 12 12 12 6 6 6 12 12 12 12 12 12 12 12 12 12 12 12 12 12 12 6 12 12 12 12 12 12 8 6 6 
6 6 6 9 12 12 12 12 12 12 12 12 12 12 12 12 12 12 12 12 12 12 6 6 6 12 12 12 12 12 12 12 12 12 12 12 12 12 12 12 12 12 12 12 12 12 12 8 6 6 
6 6 6 9 12 12 12 12 12 12 12 12 12 12 12 12 12 12 12 12 12 12 12 12 12 12 12 12 12 12 12 12 12 12 12 12 12 12 12 12 12 12 12 12 12 12 12 8 6 6 
6 6 6 9 12 10 10 10 10 10 10 10 10 10 10 12 12 12 12 12 12 12 12 12 12 12 12 12 12 12 12 12 12 12 12 12 12 12 12 12 12 12 12 12 12 12 12 8 6 6 
6 6 6 9 12 6 6 6 6 6 6 6 6 6 6 12 12 12 12 12 12 12 12 12 12 12 12 12 12 12 12 12 12 12 12 12 12 12 12 12 12 12 12 12 12 12 12 8 6 6 
6 6 6 9 12 7 7 7 7 7 7 7 7 7 7 12 12 12 12 12 12 12 6 6 6 12 12 12 12 12 12 12 12 12 12 12 12 12 12 12 12 12 12 12 12 12 12 8 6 6 
6 6 6 9 12 12 12 12 12 12 12 12 12 12 12 12 12 12 12 12 12 12 6 6 6 12 12 12 12 12 6 6 6 12 12 12 12 12 12 12 12 12 12 12 12 12 12 8 6 6 
6 6 6 9 12 12 12 12 12 12 12 12 12 12 12 12 12 12 12 12 12 12 6 6 6 12 12 12 12 12 6 6 6 12 12 12 12 12 8 6 6 6 6 6 6 6 6 6 6 6 
6 6 6 9 12 12 12 12 12 12 12 12 12 12 12 12 12 12 12 12 12 12 6 6 6 12 12 12 12 12 6 6 6 12 12 12 12 12 8 6 6 6 6 6 6 6 6 6 6 6 
6 6 6 9 12 12 12 12 12 12 6 6 12 12 12 12 12 12 12 12 12 12 6 6 6 12 12 12 12 12 12 12 12 12 12 12 12 12 8 6 6 6 6 6 6 6 6 6 6 6 
6 6 6 9 12 10 10 10 10 10 10 10 10 10 9 12 12 12 12 12 12 12 6 6 6 12 12 12 12 12 12 12 12 12 12 12 12 12 12 12 12 12 12 12 12 12 12 8 6 6 
6 6 6 9 12 6 6 6 6 6 6 6 6 6 9 12 12 12 12 12 12 12 6 6 6 12 12 12 12 12 12 12 12 12 12 12 12 12 12 12 12 12 12 19 20 20 12 8 6 6 
6 6 6 9 12 6 6 6 6 6 6 6 6 6 9 12 12 12 12 12 12 12 6 6 6 12 12 12 12 12 12 6 6 6 12 12 6 6 6 12 12 12 12 20 19 20 12 8 6 6 
6 6 6 9 12 7 7 7 7 7 7 7 7 7 7 12 12 12 12 12 12 12 6 6 6 12 12 12 12 12 12 6 6 6 12 12 6 6 6 12 12 12 12 19 20 20 12 8 6 6 
6 6 6 9 12 12 12 12 12 12 12 12 12 12 12 12 12 12 12 12 12 12 12 12 12 12 12 12 12 12 12 6 6 6 12 12 6 6 6 12 12 12 12 20 20 19 12 8 6 6 
6 6 6 9 12 12 12 12 12 12 12 12 12 12 12 12 12 12 12 12 12 12 12 12 12 12 12 12 12 12 12 12 12 12 12 12 12 12 12 12 12 12 12 12 12 12 12 8 6 6 
6 6 6 9 12 12 12 6 6 12 12 12 12 12 6 6 12 12 12 12 12 12 12 12 12 12 12 12 6 6 6 6 6 6 6 6 6 6 6 6 6 6 6 6 6 6 6 6 6 6 
6 6 6 9 12 12 12 6 6 12 12 12 12 12 6 6 12 12 12 12 12 12 6 6 6 12 12 12 12 12 12 12 12 12 12 12 12 12 12 12 12 12 12 12 12 12 12 8 6 6 
6 6 6 9 12 12 12 12 12 12 12 12 12 12 12 12 12 12 12 12 12 12 6 6 6 12 12 12 12 12 12 12 12 12 12 12 12 12 12 12 12 12 12 12 12 12 12 8 6 6 
6 6 6 9 12 6 6 6 6 6 6 6 6 6 6 6 12 12 12 12 12 12 6 6 6 12 12 12 12 12 12 12 12 12 12 12 12 12 12 12 12 12 12 12 12 12 12 8 6 6 
6 6 6 9 12 6 12 12 12 12 12 12 12 6 6 12 12 12 12 12 12 12 6 6 6 12 12 12 12 12 12 12 12 12 12 12 12 12 12 12 12 12 12 12 12 12 12 8 6 6 
6 6 6 9 12 6 12 12 12 12 12 12 12 6 12 12 12 12 12 12 12 12 6 6 6 12 12 12 6 6 6 6 6 6 6 6 6 6 6 6 6 6 6 6 6 6 6 6 6 6 
6 6 6 9 12 6 12 12 12 12 12 12 12 6 12 12 12 12 12 12 12 12 6 6 6 12 12 12 7 7 7 7 7 7 7 7 7 7 7 7 7 7 7 7 7 7 7 6 6 6 
6 6 6 9 12 6 12 12 12 12 12 12 12 6 12 12 12 12 12 12 12 12 6 6 6 12 12 12 12 12 12 12 12 12 12 12 12 12 12 12 12 12 12 12 12 12 12 8 6 6 
6 6 6 9 12 6 12 12 12 12 12 12 12 6 12 12 12 12 12 12 12 12 7 7 7 12 12 12 12 12 12 12 12 12 12 12 12 12 12 12 12 12 12 12 12 12 12 8 6 6 
6 6 6 9 12 6 12 12 12 12 12 12 12 6 12 12 12 12 12 12 12 12 12 12 12 12 12 12 12 12 12 12 12 12 12 12 12 12 12 12 12 12 12 12 12 12 12 8 6 6 
6 6 6 9 12 6 12 12 12 12 12 12 12 12 12 12 12 12 12 12 12 12 12 12 12 12 12 12 12 12 12 12 12 12 12 12 12 12 12 12 12 12 12 12 12 12 12 8 6 6 
6 6 6 9 12 6 12 12 12 12 12 12 12 12 12 12 12 12 12 12 12 12 12 12 12 12 12 12 12 12 12 12 12 12 12 12 12 12 12 12 12 12 12 12 12 12 12 8 6 6 
6 6 6 6 6 6 6 6 6 6 6 6 6 6 6 12 12 12 12 12 12 12 12 12 12 12 12 12 12 12 12 12 12 12 12 12 12 12 12 12 12 12 12 12 12 12 12 8 6 6 
6 6 6 20 20 20 12 12 12 12 12 12 12 12 6 12 12 6 6 6 6 6 6 6 6 6 6 6 6 6 6 6 6 6 6 6 6 6 6 6 6 6 6 6 6 6 6 6 6 6 
6 6 6 20 19 20 12 12 12 12 12 12 12 12 12 12 12 12 12 12 12 12 12 12 12 12 12 12 12 12 12 12 12 12 12 12 12 12 12 12 12 12 12 12 12 12 12 8 6 6 
6 6 6 20 20 19 12 12 12 12 12 12 12 12 12 12 12 12 12 12 12 12 12 12 12 12 12 12 12 12 12 12 12 12 12 12 12 12 12 12 12 12 12 6 6 6 12 8 6 6 
6 6 6 19 20 20 12 12 12 12 12 12 12 12 6 12 12 12 12 12 12 12 12 12 12 12 12 12 12 12 12 12 12 12 12 12 12 12 12 12 12 12 12 12 12 6 12 8 6 6 
6 6 6 20 20 20 12 12 12 12 12 12 12 12 6 12 12 12 12 12 12 12 12 12 12 12 12 12 12 12 12 12 12 12 12 12 12 12 12 12 12 12 12 6 6 6 12 8 6 6 
6 6 6 20 20 19 12 12 12 12 12 12 12 12 6 12 12 12 12 12 12 12 12 6 6 6 12 12 12 12 12 12 12 12 12 12 12 12 12 12 12 12 12 12 12 12 12 8 6 6 
6 6 6 6 10 10 10 10 10 10 10 10 10 10 10 10 10 10 10 10 10 10 10 10 10 10 10 10 10 10 10 10 10 10 10 10 10 10 10 10 10 10 10 10 10 10 10 6 6 6 
6 6 6 6 6 6 6 6 6 6 6 6 6 6 6 6 6 6 6 6 6 6 6 6 6 6 6 6 6 6 6 6 6 6 6 6 6 6 6 6 6 6 6 6 6 6 6 6 6 6 
6 6 6 6 6 6 6 6 6 6 6 6 6 6 6 6 6 6 6 6 6 6 6 6 6 6 6 6 6 6 6 6 6 6 6 6 6 6 6 6 6 6 6 6 6 6 6 6 6 6 
6 6 6 6 6 6 6 6 6 6 6 6 6 6 6 6 6 6 6 6 6 6 6 6 6 6 6 6 6 6 6 6 6 6 6 6 6 6 6 6 6 6 6 6 6 6 6 6 6 6 
