18 18 18 18 18 18 18 18 18 18 18 18 18 18 18 18 18 18 18 18 18 18 18 18 18 18 18 18 18 18 18 18 18 18 18 18 18 18 18 18 18 18 18 18 18 18 18 18 18 18 
18 18 18 18 18 18 18 18 18 18 18 18 18 18 18 18 18 18 18 18 18 18 18 18 18 18 18 18 18 18 18 18 18 18 18 18 18 18 18 18 18 18 18 18 18 18 18 18 18 18 
18 18 18 18 18 18 18 18 18 18 18 18 18 18 18 18 18 18 18 18 18 18 18 18 18 18 18 18 18 18 18 18 18 18 18 18 18 18 18 18 18 18 18 18 18 18 18 18 18 18 
18 18 18 18 18 18 18 18 18 18 18 18 18 18 18 18 18 18 18 18 18 18 18 18 18 18 18 18 18 18 18 18 18 18 18 18 18 18 18 18 18 18 18 18 18 18 18 18 18 18 
18 18 18 18 18 18 18 18 18 18 18 18 18 18 18 18 18 18 18 18 18 18 18 18 18 20 19 20 20 19 20 20 20 19 18 18 18 18 18 18 18 18 18 18 18 18 18 18 18 18 
18 18 18 18 18 18 18 18 18 18 18 18 18 18 18 18 18 18 18 18 18 18 18 18 18 18 18 18 20 19 20 18 18 18 18 18 18 18 14 14 14 14 14 18 18 18 18 18 18 18 
18 18 18 18 18 18 14 14 14 14 14 14 14 14 14 14 14 14 18 18 18 18 18 18 18 18 18 18 14 14 14 14 14 14 14 14 14 14 14 18 18 18 18 18 18 18 18 18 18 18 
18 18 18 18 18 18 14 14 14 14 14 14 14 14 14 14 14 14 18 18 18 18 18 18 18 18 18 18 14 14 14 18 18 18 18 18 18 18 18 18 18 18 18 18 18 18 18 18 18 18 
18 18 18 18 18 18 5 14 14 5 14 14 5 14 14 14 14 14 18 18 18 18 18 18 18 18 18 18 14 14 14 18 18 18 18 18 18 18 18 18 18 18 18 18 18 18 18 18 18 18 
18 18 18 18 18 18 18 18 18 18 18 18 18 18 18 14 14 14 18 18 18 18 18 18 18 18 18 18 14 14 14 18 18 18 18 18 18 18 18 18 18 18 18 18 18 18 18 18 18 18 
18 18 18 18 18 18 18 18 18 18 18 18 18 18 18 14 14 14 14 14 14 14 5 14 14 14 14 14 14 14 14 18 18 18 18 18 18 18 18 18 18 18 18 18 18 18 18 18 18 18 
18 18 18 18 18 18 18 18 18 18 18 18 18 18 18 14 14 14 14 14 14 14 14 14 14 14 14 14 14 14 14 18 18 18 18 18 18 18 18 18 18 18 18 18 18 18 18 18 18 18 
18 18 18 18 18 18 18 18 18 18 18 18 18 18 18 14 14 14 14 14 14 14 5 14 14 14 14 14 14 14 14 14 14 14 14 14 14 14 14 14 14 14 14 14 18 18 18 18 18 18 
18 18 18 18 18 18 18 18 18 18 18 18 18 18 18 14 14 14 18 18 18 18 18 18 18 18 18 18 14 14 14 14 14 14 14 14 14 14 14 14 14 14 14 14 18 18 18 18 18 18 
18 18 18 18 18 18 18 18 18 18 18 18 18 18 18 14 14 14 18 18 18 18 18 18 18 18 18 18 14 14 14 14 14 14 14 14 14 14 14 14 14 14 14 14 14 14 15 18 18 18 
18 18 18 18 18 18 18 18 18 18 18 18 18 18 18 14 14 14 18 18 18 18 18 18 18 18 18 18 14 14 14 18 18 18 18 18 18 18 18 18 18 18 18 18 18 18 18 18 18 18 
18 18 18 18 14 14 18 14 14 14 14 14 14 14 14 14 14 14 20 19 18 18 18 18 18 18 18 18 14 14 14 18 18 18 18 18 18 18 18 18 18 18 18 18 18 18 18 18 18 18 
18 18 18 18 2 14 14 14 14 14 14 14 14 14 14 14 14 14 20 20 18 18 18 18 18 18 18 18 14 14 14 18 18 18 18 18 18 18 18 18 18 18 18 18 18 18 18 18 18 18 
18 18 18 18 14 14 18 14 14 14 14 14 14 14 14 14 14 14 19 20 18 18 18 18 18 18 18 18 14 14 14 18 18 18 18 18 18 18 18 18 18 18 18 18 18 18 18 18 18 18 
18 18 18 18 18 18 18 18 18 18 18 18 18 18 18 14 14 14 20 19 18 18 18 18 18 18 18 18 14 14 14 18 18 18 18 18 18 18 18 18 18 18 18 18 18 18 18 18 18 18 
18 18 18 18 18 18 18 18 18 18 18 18 18 18 18 14 14 14 20 20 18 18 18 18 18 18 18 18 14 14 14 14 14 14 14 14 14 14 14 14 14 14 14 14 14 14 18 18 18 18 
18 18 18 18 18 18 18 18 18 18 18 18 18 18 18 14 14 14 18 18 18 18 18 18 18 18 18 18 14 14 14 14 14 14 14 14 14 14 14 14 14 14 14 14 14 14 18 18 18 18 
18 18 18 18 18 18 18 18 18 18 18 18 18 18 18 14 14 14 18 18 14 14 14 14 14 14 18 18 14 14 14 14 14 14 14 14 14 14 14 14 14 14 14 14 14 14 18 18 18 18 
18 18 18 18 18 18 18 18 18 18 18 18 18 18 18 14 14 14 18 18 14 14 14 14 14 14 18 18 14 14 14 18 18 18 18 18 18 18 18 18 18 18 18 18 18 18 18 18 18 18 
18 18 18 18 18 18 18 18 18 18 18 18 18 18 18 14 14 14 18 18 14 14 14 14 14 14 18 18 14 14 14 18 18 18 18 18 18 18 18 18 18 18 18 18 18 18 18 18 18 18 
18 18 18 18 18 18 18 18 18 18 18 18 18 18 18 14 14 14 18 18 14 14 14 14 14 14 18 18 14 14 14 18 18 18 18 18 18 18 18 18 18 18 18 18 18 18 18 18 18 18 
18 18 18 18 18 18 14 14 14 14 14 14 14 14 14 14 14 14 18 18 18 18 14 14 18 18 18 18 14 14 14 18 18 18 18 18 18 18 18 18 18 18 18 18 18 18 18 18 18 18 
18 18 18 18 18 18 14 14 14 14 14 14 14 14 14 14 14 14 18 18 18 18 14 14 18 18 18 18 14 14 14 18 18 18 18 18 18 18 18 18 18 18 18 18 18 18 18 18 18 18 
18 18 18 18 18 18 14 14 14 14 14 14 14 14 14 14 14 14 18 18 18 18 14 14 18 18 18 18 14 14 14 18 18 18 18 18 18 18 18 18 18 18 18 18 18 18 18 18 18 18 
18 18 18 18 18 18 18 18 18 18 18 18 18 18 18 18 14 14 18 18 18 18 14 14 18 18 18 18 14 14 14 18 18 18 18 18 18 18 18 18 18 18 18 18 18 18 18 18 18 18 
18 18 18 18 18 18 18 18 18 18 18 18 18 18 18 18 14 14 18 18 18 18 14 14 18 18 18 18 14 14 14 18 18 18 18 18 18 18 18 18 18 18 18 18 18 18 18 18 18 18 
18 18 18 18 18 18 18 18 18 18 18 18 18 18 18 18 14 14 18 18 18 18 14 14 18 18 18 18 14 14 14 18 18 18 18 18 18 18 18 18 18 20 19 20 20 20 19 20 18 18 
18 18 18 18 18 18 18 18 18 18 18 18 18 18 18 18 14 14 18 18 18 18 14 14 18 18 18 18 14 14 14 18 18 18 18 18 18 18 18 18 18 20 20 19 20 19 20 20 18 18 
18 18 18 18 18 18 18 18 18 18 18 18 18 18 18 18 14 14 18 18 18 18 14 14 18 18 18 18 14 14 14 18 18 18 18 18 18 18 18 18 18 18 18 20 20 20 18 18 18 18 
18 18 18 18 18 20 18 18 18 18 18 18 18 18 18 18 14 14 18 18 18 18 14 14 18 18 18 18 14 14 14 18 18 18 18 18 18 18 18 18 18 18 18 20 19 20 18 18 18 18 
18 18 18 18 18 20 18 18 18 18 18 18 18 18 18 18 14 14 18 18 18 18 14 14 18 18 18 18 14 14 14 18 18 18 18 18 18 18 18 18 18 18 18 14 14 14 18 18 18 18 
18 18 18 18 18 19 14 14 14 14 14 14 14 14 14 14 14 14 14 14 14 14 14 14 14 14 14 14 14 14 14 14 14 14 14 14 14 14 14 18 18 18 18 14 14 14 18 18 18 18 
18 18 18 18 18 19 14 14 14 14 14 14 14 14 14 14 14 14 14 14 14 14 14 14 14 14 14 14 14 14 14 14 14 14 14 14 14 14 14 14 14 14 14 14 14 14 18 18 18 18 
18 18 18 18 18 20 18 18 18 18 18 18 18 18 18 18 14 14 14 14 14 14 14 14 14 14 14 14 14 14 14 14 14 14 14 14 14 14 14 14 14 14 14 14 14 14 18 18 18 18 
18 18 18 18 18 20 18 18 18 18 18 18 18 18 18 18 14 14 18 18 18 18 18 18 18 18 18 18 18 18 18 18 18 18 18 18 18 18 14 14 14 14 14 14 14 14 18 18 18 18 
18 18 18 18 18 18 18 18 18 18 18 18 18 18 18 18 14 14 18 18 18 18 18 18 18 18 18 18 18 18 18 18 18 18 18 18 18 18 18 18 18 18 18 14 14 14 18 18 18 18 
18 18 18 18 18 18 14 14 14 14 14 14 14 14 14 18 14 14 18 18 18 18 18 18 18 18 18 18 18 18 18 18 18 18 18 18 18 18 18 18 18 18 18 14 14 14 18 18 18 18 
18 18 18 18 18 18 14 14 14 14 14 14 14 14 14 18 14 14 18 18 18 18 18 18 18 18 18 18 18 18 18 18 18 18 18 18 18 18 18 18 18 18 18 14 14 14 18 18 18 18 
18 18 18 18 18 18 14 14 18 18 18 18 18 14 14 14 14 14 14 18 14 14 14 14 14 14 14 18 18 18 18 18 18 18 18 18 18 18 18 18 18 18 15 14 14 14 15 18 18 18 
18 18 18 18 18 18 14 14 18 18 18 18 1 18 14 14 14 14 14 14 14 14 14 14 14 14 14 14 14 16 14 14 16 14 14 16 14 14 16 14 14 16 14 14 14 14 14 18 18 18 
18 18 18 18 18 16 14 14 16 18 18 18 14 14 14 14 14 14 14 18 14 14 14 14 14 14 14 14 14 14 14 14 14 14 14 14 14 14 14 14 14 14 14 14 14 14 14 18 18 18 
18 18 18 18 18 14 14 14 14 18 18 18 18 18 18 18 18 18 18 18 18 18 18 18 18 18 18 18 14 16 14 14 16 14 14 16 14 14 16 14 14 16 14 14 14 14 15 18 18 18 
18 18 18 18 18 18 18 18 18 18 18 18 18 18 18 18 18 18 18 18 18 18 18 18 18 18 18 18 18 18 18 18 18 18 18 18 18 18 18 18 18 18 18 18 18 18 18 18 18 18 
18 18 18 18 18 18 18 18 18 18 18 18 18 18 18 18 18 18 18 18 18 18 18 18 18 18 18 18 18 18 18 18 18 18 18 18 18 18 18 18 18 18 18 18 18 18 18 18 18 18 
18 18 18 18 18 18 18 18 18 18 18 18 18 18 18 18 18 18 18 18 18 18 18 18 18 18 18 18 18 18 18 18 18 18 18 18 18 18 18 18 18 18 18 18 18 18 18 18 18 18 
